Ба́за – base
Би́ржа – stock exchange
Вечери́нка – party
Данти́ст – dentist
Ка́чественный – quality (adjective)
Копи́р – copier
Но́вость(-и) – news
Отдыха́ть/отдохнуть – to rest, to holiday
Па́пка – folder
Перспекти́ва – perspective, outlook
Пси́хика – psyche
Рассказа́ть (расскажи́) – to tell (tell me)
Ру́сский – Russian
Спелео́лог – speleologist
Статья́ – article
У – at
Фило́лог – philologist
Юг – south
Апельси́новый – orange (made of oranges, for ex. juice)
Ви́деть – to see
Вку́сно – tasty (adverb)
Вку́сный – tasty
Вот – 1.here is, 2. there, now, well (coll.)
Глу́пый – silly, dumb, stupid
Дешёвый – cheap
Дина́мик – speaker
Дли́нный – long
Дорога́я – 1. (of a thing) – expensive, 2.(of a wife or a woman) - dear
Дорого́й – 1. (of a thing) – expensive, 2. (of a husband or a man) - dear
Ещё – more
За́нят (а, ы) – to be busy
Звук – sound
Конфере́нция – conference, meeting
Мавзоле́й – Mausoleum
Мину́та – minute
Неудо́бный – not comfortable
Ни́зкий – low
Нра́виться/понра́виться (например: мне нра́вится, мне понра́вилось) – to like (I like/ I liked)
О́вощ – vegetable (n.)
Овощно́й – vegetable (adj.)
Па́мять – memory
Пане́ль – panel
Пеще́ра – cave
Пла́зменный (adj.) – Plasma Display panel
По́ле – field
После́дний – last
Посмотри́те! (инфин. Посмотреть) – Look!
Пото́м – then, after
Про́бка – traffic jam
Прохо́жий – passer-by
Раз – one time, one
Са́мый – the most
Скажи́ (инфин. сказа́ть) – say, tell
Слу́жба (1.как рабо́та 2. как проце́ссия в це́ркви) – 1. work 2. church-office
Собра́ние – meeting, gathering (Сегодня у меня собрание на работе)
Спо́рить – to argue
Спра́шивать/спросить – to ask
Стиль – style
Сти́льный – stylish, trendy
У́зкий – tight, narrow
Уста́л(а, и) (инфин. Уста́ть) – (I am, he is) tired
Це́рковь – church
Че́рез – through, in (+ time)
Чи́стый – clean
Широ́кий – wide
Бе́гать – to run
Близнецы́ – twins
Да́же – even
Жара́ – heat
За́мужем – to be married (about a woman)
Кра́ска – paint (n.)
Отчёт – report
Переда́й приве́т – send one’s best
Пистоле́т – hand gun
Пря́ник – gingerbread
Позавчера́ – a day before yesterday
Послеза́втра – a day after tomorrow
Прести́жно – prestigious (adverb)
Со́весть – conscience
Счёт – 1. bill, check; 2. account (in a bank)
Труд – labor
Уво́лен – (he is) fired, dismissed
Анато́мия – anatomy
Аэро́бика – aerobics
Банкро́т – bankrupt
Вальс – waltz
Ви́лка – fork
Бо́лен – (I am or he is) ill
Болта́ть – 1. to chat, gossip (Сего́дня мы болта́ли с подру́гой.) 2. to propel, shake (Болтать яйца, сыр, и молоко в миске.)
Гря́зный – dirty
Зарпла́та – salary
Лени́вый – lazy
На посошо́к – (drink the) parting cup
Ненави́деть – to hate
Отде́л – department
Оптимизи́ровать – optimize
Похме́лье – hangover, crapulence, morning after
Проща́ться/ попроща́ться – to say goodbye
Стира́льная маши́на – washing machine
Пила́тес – Pilates
Пле́ер – media player
Сто́пка – shot glass
Судья́ – judge
Стра́шно – scary
Целова́ться – to kiss (as a process)
Худо́й – slim, skinny, thin
Услу́га (услу́ги) – service
Ужа́сно – terrible, horrible, awful
Та́нец (та́нцы) – dance (dancing party)
То́чно – exactly
Терапи́я – therapy
Трениро́вка – training
Увлека́ться – be carried away (by); take a great interest (in); be keen (on)
Распрода́жа – sales, sell-out
Ритм – rhyme
Фле́шка – flash card, memory stick






















